Fred	Pixope
Steve	Dabjam
Betty	Eire
Todd	Dynabox
Antonio	Bubblemix
Thomas	Oodoo
Wayne	Eire
Douglas	Gabcube
Jerry	Zoonder
Karen	Skidoo
Steven	Photolist
Beverly	Thoughtstorm
Joe	Vinder
Linda	InnoZ
Carolyn	Aimbo
Sean	Zoomlounge
Deborah	Myworks
Lori	Myworks
Cheryl	Youspan
Susan	Yacero
Anthony	Twitterlist
Judy	Photobug
Shawn	Pixonyx
Doris	Aimbu
Sandra	Jaxbean
Joseph	Bubbletube
Victor	Tambee
Michael	Flipbug
Randy	Einti
Gloria	Dabshots
Annie	Jetwire
Jonathan	Fivespan
Gary	Eidel
Jesse	Riffpedia
Marilyn	Skimia
Julia	Plambee
Lillian	Avamm
Harold	Ozu
Janice	Yakijo
Eugene	Aimbu
Willie	Feedspan
Brenda	Omba
Billy	Skalith
Alice	Oyoba
Nicholas	Bluezoom
Bonnie	Fivebridge
Carlos	Thoughtworks
Cynthia	Skinder
Craig	Yadel
Martin	Zava
Joan	Ooba
Ann	Jaxnation
Ryan	Dynabox
Lisa	Eimbee
Robert	Flashdog
Ronald	Buzzdog
Emily	Livetube
Jack	Zooxo
Carl	Aivee
Rose	Mita
Anne	Quinu
Howard	Talane
Jean	Oyoloo
Arthur	Skyble
Andrew	Omba
Kathy	Zoombox
Jose	Eidel
Charles	Thoughtstorm
Patrick	Quire
Raymond	Tagchat
Mildred	Nlounge
Donald	Yombu
Stephanie	Bubbletube
Eric	Topiclounge
Kenneth	Dynazzy
Terry	Realbuzz
Jeffrey	Tekfly
Daniel	Miboo
Carol	Topiclounge
Martha	Brainverse
Alan	Kayveo
Brian	Aimbo
Rebecca	Layo
Sharon	Realbuzz
Henry	Skiptube
Barbara	Quinu
Shirley	Einti
Jennifer	Fliptune
Earl	Myworks
Evelyn	Wordware
Jimmy	Rooxo
Elizabeth	Brainverse
Roger	Twitterworks
Lois	Wikido
Kevin	Cogilith
Lawrence	Skibox
Margaret	Fivebridge
Christopher	Skipstorm
Anna	Gabvine
Andrea	Buzzdog
Heather	Flipopia
Kelly	Lazzy
Stephen	Yamia
Amy	Lazzy
David	Yakijo
William	Rhybox
Harry	Photofeed
Ernest	Zoomlounge
Dennis	Divavu
Marie	Cogilith
Jessica	Brainlounge
John	Roombo
Virginia	Meejo
Julie	Linkbridge
Larry	Riffwire
Samuel	Bubblemix
Timothy	Photobean
Johnny	Jaxnation
Robin	Photobean
Tammy	Skilith
Jason	Wikibox
Frank	Feedbug
Walter	Jabbercube
Scott	Cogibox
Juan	Kayveo
Christine	Realcube
James	Thoughtworks
Richard	Fatz
Amanda	Mybuzz
Helen	Feedfire
Paula	Fivespan
Clarence	Brainsphere
Judith	Jabbercube
Sara	Kwideo
Michelle	Rhyzio
Bruce	Omba
Pamela	Aivee
Patricia	Quimm
Catherine	Tagchat
Nicole	Snaptags
Louise	Skyvu
Matthew	Minyx
Diana	Talane
Adam	Ailane
Paul	Edgetag
Joyce	Zoombox
Diane	Demivee
Peter	Omba
Jeremy	Innojam
Denise	Yacero
Angela	Talane
Kathryn	Quimba
Aaron	Yodo
Keith	Voolia
Laura	Photobean
Donna	Skibox
Jane	Jetpulse
Jacqueline	Trudeo
Ruth	Brainlounge
Mary	Photolist
Kathleen	Bubblemix
Janet	Buzzdog
Russell	Zoomcast
Phyllis	Jabbersphere
Debra	Oozz
Teresa	Brightbean
Louis	Kazio
Ashley	Tanoodle
Philip	Ainyx
Tina	Zooxo
Mark	Agimba
Wanda	Oodoo
Maria	Oyoloo
Katherine	Quire
Ruby	Skynoodle
Justin	Layo
Gerald	Thoughtstorm
Edward	Zoomlounge
Roy	Rooxo
Chris	Divanoodle
Nancy	Pixonyx
Theresa	Quinu
Irene	Dablist
Christina	Photofeed
Joshua	Linkbuzz
Ralph	Jaloo
Melissa	Skalith
George	Tagtune
Sarah	Jaxbean
Norma	Quimm
Albert	Jabbercube
Benjamin	Feedspan
Frances	Skipfire
Rachel	DabZ
Brandon	Twimm
Phillip	Kazio
Dorothy	Quamba
Gregory	Ailane
Kimberly	Zoozzy
Olivia	JumpXS
Zelenia	Voolia
Chase	Zoomlounge
Ciara	Jabberstorm
Delilah	Yamia
Igor	Gabcube
Kiona	Kaymbo
Ivy	Vinte
Noah	Skinder
Winifred	Yakijo
Hope	Minyx
Lillith	Buzzdog
Jade	Trilith
Lane	Brainbox
Tobias	Jabbertype
Priscilla	Fivebridge
Hedy	Ozu
Uriel	Quimm
Quentin	Vinte
Nash	Divape
Shaine	Innojam
Haley	Ailane
Remedios	Gabtune
Isaiah	Skidoo
Orlando	Zoonder
Zena	Geba
Kiara	Tazzy
Sigourney	Voomm
Nita	Skilith
Quyn	Eabox
Teagan	Cogidoo
Josephine	Eidel
Ashton	Zoombox
Nell	Skinder
Allen	Zava
Kennan	Agimba
Mannix	Rhyzio
Barrett	Voolia
Kylan	Kwideo
Byron	Oozz
Jorden	Latz
Clare	Mudo
Sawyer	Podcat
Gail	Janyx
Hiram	Camido
Sierra	Voolia
Calvin	Tavu
Leslie	Edgeify
Cecilia	Skibox
Sopoline	Browsecat
Irma	Zoomlounge
Ingrid	Layo
Mohammad	Avaveo
Sonia	Zoombox
Martena	Ozu
Fallon	Skyble
Kiayada	Oba
Merrill	Flashpoint
Stewart	Skilith
Lester	Thoughtworks
Hanae	BlogXS
Florence	Meedoo
Laith	Eayo
Odysseus	Vinte
Kylie	DabZ
Hamilton	Gabcube
Tate	Linklinks
Desirae	Gigaclub
Jenna	Skilith
Maite	Voomm
Jonas	Oyoba
Clark	JumpXS
Joel	Gigashots
Tad	Chatterbridge
Uta	Aimbo
Stella	Vinder
Rhona	Meedoo
Quintessa	Skippad
Abbot	Zoozzy
Nathaniel	Edgewire
Ashely	Skyba
Yuli	Jabberbean
Bobby	Digitube
Christop	Devbug
Josuah	Gabtune
Jacob	Lazzy
Alexande	Mydo
Tyler	Linkbridge
Zachary	Brainbox
Austin	Devbug
Kyle	Eabox
Nathan	Yamia
Cody	Vitz
Jordan	Meejo
Dylan	Oyoyo
Jeremiah	Skyble
Lewis	Midel
Derek	Meembee
Cameron	Photofeed
Travis	JumpXS
Caleb	Livepath
Jared	Teklist
Ethan	Flipopia
Taylor	Agimba
Logan	Brainsphere
Trevor	Oyoba
Dustin	Quamba
Evan	Skynoodle
Gabriel	Ooba
Ian	Yamia
Connor	Zoombox
Anton	Skivee
Devin	Meevee
Corey	Gabtype
Jesus	Youbridge
Hunter	Podcat
Colin	Gabspot
Bradley	Skyba
Garrett	Photofeed
Mitchell	Edgewire
Allan	Realblab
Dakota	Tagpad
Shane	Yombu
Blake	Feedfire
Miguel	Skilith
Luke	Bubblemix
Adrian	Thoughtblab
Seth	Oba
Isaac	Edgeblab
Max	Yadel
Spencer	Skyndu
Vincent	Blogpad
Jorge	Vidoo
Lucas	Camido
Francis	Jabbertype
Cory	Blognation
Tanner	Vitz
Brett	Gevee
Erik	Fliptune
Brendan	Quimba
Dalton	Dynabox
Alejandr	Wordware
Terence	Tanoodle
Dominic	Skinder
Cole	Geba
Dillon	Vimbo
Jake	Zoomcast
Damien	Latz
Elijah	Agivu
Mason	Yadel
Wesley	Mycat
Casey	Photobean
Eduardo	Kaymbo
Colton	Tazzy
Laurence	Blogtags
Chad	Twitterbridge
Julian	Blogtags
Devon	Riffpath
Oscar	Leenti
Mario	Mudo
Manuel	Bluejam
Bryce	Quaxo
Grant	Voonte
Xavier	Snaptags
Javier	Rhynyx
Edgar	Aimbu
Omar	Gabtype
Hector	Skyvu
Frederic	Gabvine
Tristan	Gigashots
Troy	Innojam
Emanuel	Mudo
Sergio	Flipstorm
Ferdinan	Oyoba
Andre	Thoughtworks
Edwin	Devcast
Ivan	Skipfire
Cristian	Fliptune
Clayton	Teklist
Levi	Dabtype
Curtis	Quaxo
Darius	Zazio
Reuben	Mudo
Andres	Gevee
Daren	Plambee
Cesar	Kayveo
Drew	Topicstorm
Pedro	Aimbo
Alexis	Thoughtworks
Daryl	Yakijo
Brent	Yombu
Marco	Mymm
Julio	Rhyzio
Riley	Chatterpoint
Wyatt	Topiczoom
Malik	Youspan
Leonard	Blogpad
Tony	Kazio
Rafael	Jaxspan
Preston	Feedspan
Miles	Thoughtsphere
Erick	Tekfly
Brady	Kayveo
Raul	Mymm
Zachery	Tazzy
Loren	DabZ
Hayden	Fadeo
Gavin	Skyndu
Kristoph	Janyx
Trenton	Innotype
Colby	Katz
Sebastia	Fivechat
Harrison	Agivu
Parker	Fadeo
Alberto	Rhyloo
Chance	Kaymbo
Kaleb	Leexo
Rodney	Thoughtbeat
Gerardo	Oodoo
Theodore	Linklinks
Micah	Gabtune
Lance	Meevee
Marcos	Aimbu
Trey	Meemm
Conner	Edgeify
Abraham	Flashdog
Giovanni	Wikido
Armando	Skalith
Dominiqu	Omba
Diego	Blogpad
Skyler	Gigashots
Gage	Oyoba
Enrique	Voonix
Donovan	Roomm
Chandler	Mybuzz
Ramon	Fanoodle
Zackary	Zoomcast
Ross	Topicshots
Landon	Minyx
Harley	Mynte
Jay	Mudo
Trent	Divavu
Gilbert	Minyx
Jamal	Centimia
Israel	Dablist
Randall	Gabspot
Branden	Miboo
Neil	Riffwire
Alfredo	Tagpad
Elliott	Tagpad
Sidney	Quimba
Deandre	Livetube
Jalen	Oyoloo
Morgan	Topicshots
Reginald	Chatterbridge
Nolan	Miboo
Lee	Mudo
Zacharia	Eidel
Liam	Meezzy
Dante	Thoughtsphere
Marvin	Mita
Arturo	Jazzy
Maurice	Brainbox
Josiah	Gevee
Kelvin	Oodoo
Malcolm	Avamm
Kody	Skimia
Gustavo	Skynoodle
Marquis	Skyble
Dallas	Thoughtsphere
Glen	Mynte
Nelson	Avamba
Salvador	Vinder
Ty	Shuffletag
Tevin	Ozu
Brock	Thoughtbeat
Avery	Jabbersphere
Conor	Zoomlounge
Owen	Digitube
Fabian	Aimbo
Brennan	Innojam
Dean	Zoozzy
Rene	Trilith
Duane	Yacero
Clinton	Quimm
Marshall	Feedfire
Demetriu	Centimia
Pablo	Demivee
Carter	Jaxbean
Zane	Dabjam
Bailey	Feedbug
Ismael	Quatz
Ernesto	Oyoba
Terrell	Yakitri
Quinton	Photobug
Carson	Skyble
Felix	Brainsphere
Desmond	Shufflester
Elias	Browsetype
Kendall	Brainsphere
Eli	Realbridge
Hugh	Avamm
Tyrone	Quatz
Angelo	Thoughtsphere
Jerome	Agivu
Melvin	Riffpath
Simon	Bubbletube
Jakob	Oyoyo
Brenden	Kayveo
Forrest	Tekfly
Braden	InnoZ
Saul	Podcat
Esteban	Feedfire
Zackery	Kazio
Drake	Jazzy
Griffin	Oba
Jarret	Omba
Roman	Lazzy
Guillerm	Mita
Emilio	Zoozzy
Aidan	Devshare
Alvin	Zooxo
Leonardo	Gabvine
Devante	Gabcube
Tucker	Devcast
Oliver	Divavu
Keegan	Devbug
Dale	Avamm
Kameron	Livetube
Cedric	Twitterbridge
Irvine	Livepath
Abel	Cogibox
Keenan	Npath
Quinn	Tagcat
Moises	Brightbean
Stanley	Janyx
Wade	Bubbletube
Jordon	Dabjam
Alonzo	Skinder
Weston	Innojam
Denzel	Tambee
Felipe	Wikizz
Devonte	Vinder
Cooper	Kayveo
Jarrod	Shufflester
Jermaine	Chatterpoint
Rodolfo	Fivebridge
Kendrick	Quamba
Tyrell	Muxo
Graham	Oyoba
Beau	Gigashots
Kyler	Minyx
Warren	Rhycero
Donte	Jamia
Joey	Mudo
Kurt	Divanoodle
Clay	Eimbee
Noel	Brainlounge
Devan	Pixoboo
Skylar	Thoughtworks
Dane	Vidoo
Corbin	Dynabox
Kristian	Dabshots
Nikolas	Bluezoom
Alfred	Geba
Jarred	Skyvu
Peyton	Linkbuzz
Rudy	Edgeify
Bryson	Rhybox
Alfonso	Roomm
Darian	Shuffletag
Shaquill	Teklist
Brad	Dynazzy
Trevon	Skinder
Lukas	Kamba
Reid	Plajo
Toby	Gabspot
Davis	Quaxo
Deshawn	Thoughtstorm
Wilson	Photospace
Darnell	Gabspot
Davon	Linklinks
Sheldon	DabZ
Rodrigo	Buzzdog
Justice	Devcast
Jayson	Wordware
Marlon	Thoughtworks
Ali	Topiclounge
Rashad	Fatz
Sterling	Trudeo
Ariel	Skilith
Brody	Voonix
Efrain	Cogilith
Julius	Livefish
Rolando	Roomm
Ramiro	Oba
Kurtis	InnoZ
Keaton	Voonix
Tylor	Miboo
Reed	Livefish
Mackenzi	Meemm
Javon	Dynazzy
Bernard	Aivee
Braxton	Mydo
Payton	Katz
Marquise	Abatz
Barry	Plajo
Rees	Jaxbean
Tyson	Photospace
Clint	Mydo
Daquan	Roomm
Blaine	Linklinks
Santiago	Gabtune
Khalil	Lazzy
Nathanae	Skalith
Perry	Jabbercube
Lamar	Lazzy
Nigel	Brainlounge
Grayson	Twitterwire
Roderick	Twitterlist
Tristen	Flipstorm
Brayden	Vinte
Bret	Zoomcast
Clifford	Flipbug
Mauricio	Jaxspan
Quincy	Fivespan
Rogelio	Twinte
Dexter	Riffpedia
Adan	Geba
Kirk	Tagpad
Kory	Vinder
Dorian	Jabberbean
Gordon	Lazzy
Heath	Dynazzy
Deon	Topicshots
Brenton	Tagcat
Norman	Kwilith
Tyree	Centidel
Courtney	Meemm
Jace	Buzzdog
Jaquan	Blogtags
Alvaro	Divape
Duncan	Katz
Demarcus	Tagchat
Humberto	Youtags
Osvaldo	Thoughtsphere
Deangelo	Meemm
Dwight	Riffpath
Jarvis	Lazzy
Vicente	Tagtune
Markus	Jazzy
Reynaldo	Edgeify
Noe	Janyx
Amir	Twinte
Ezekiel	Edgeify
Chaz	Kwilith
Greg	Rhyloo
Deonte	Avaveo
Kasey	Ooba
Jamar	Ailane
Shelby	Livepath
Leroy	Camido
Damion	Vinte
Darien	Muxo
Quintin	Brainverse
Stephon	Ooba
Roland	Flipopia
Ahmad	Dabtype
Corneliu	Brainlounge
Jaron	Aimbo
Milton	JumpXS
Everett	InnoZ
Coty	Jabbersphere
Triston	Brainbox
Shannon	Miboo
Cade	Linktype
Antwan	Skalith
Joaquin	Tagchat
Tracy	Shufflester
Lonnie	Topiclounge
Colten	Jetpulse
Jarod	Zoozzy
Addison	Skalith
Salvator	Gigashots
Jaden	Rhynyx
Walker	Digitube
Arnold	Brightbean
Solomon	Jamia
Leonel	Tagopia
Korey	Brainlounge
Brice	Thoughtblab
Dion	Browsetype
Kareem	Yamia
Mohammed	Oyoloo
Edgardo	Thoughtbeat
Dashawn	Babbleopia
Ezequiel	Kazio
Jan	Agivu
Adolfo	Flipopia
Tre	Zazio
Rigobert	Eire
Jovan	Mycat
Vernon	Gigaclub
Guadalup	Skyble
Holden	Kwideo
Raphael	Feedspan
Deion	Aivee
Dandre	Divavu
Dillan	Gabspot
Herbert	Brainverse
Tristin	Minyx
Cullen	Devshare
Coleman	Mydo
Marcel	Chatterpoint
Kristofe	Plambee
Jaylen	Gabvine
Clifton	Photobean
Rick	Twiyo
Raheem	Linklinks
Deven	Skyvu
Jimmie	Oba
Lamont	Shuffletag
Jamel	Skilith
Kent	Linkbuzz
Dawson	DabZ
Ezra	Eamia
German	Eamia
Nestor	Youfeed
Cortez	Zooxo
Darion	Skilith
Rory	Zoomdog
Lloyd	Photobean
Moses	Kwideo
Malachi	Avaveo
Guy	Realcube
Ahmed	Leenti
Rickey	Riffpedia
Axel	Oyonder
Kerry	Zoozzy
Agustin	Mycat
Conrad	Riffpath
Brooks	Photospace
Darrius	Tagpad
Jerrod	Meevee
Dana	Skippad
Akeem	Skippad
Santos	Kayveo
Bernardo	Skinder
Kai	Photolist
Winston	Quaxo
Ignacio	Yamia
Gunnar	Pixoboo
Juwan	Skyvu
Kolby	Divanoodle
Jefferso	Edgeify
Wilfredo	Livepath
Pierce	Jaxworks
Blair	Quaxo
Gerard	Reallinks
Heribert	JumpXS
Elmer	Jaxbean
Houston	Thoughtsphere
Rashawn	Quire
Dimitri	Gabvine
Elvis	Youtags
Jasper	Cogidoo
Jairo	Oyoba
Colt	Quaxo
Donnie	Thoughtworks
Sage	Zooxo
Madison	Mynte
Kaden	Kaymbo
Mohamed	Kamba
Wendell	Thoughtbeat
Bradford	Leexo
Jamison	Gabtune
Dequan	Skippad
Gene	Rhycero
Jameson	Wordtune
Gonzalo	Skyble
Rhett	Leenti
Bennett	Twitterlist
Moshe	Yamia
Kade	Rhyloo
Isaias	Tazzy
Davonte	Jabberbean
Thaddeus	Feedfish
Camden	Oyoba
Davion	Trudeo
Jamil	Leenti
Misael	Jaloo
Travon	Leexo
Leland	Wordware
Trever	Jayo
Hassan	Plajo
Cruz	Edgewire
Donavan	Tagpad
Paris	Roombo
Nico	Zoomlounge
Ladarius	Gabspot
Zakary	Buzzster
Gino	Minyx
Pierre	Oyoyo
Kolton	Latz
Jaleel	Blogtags
Trace	Photobean
Dewayne	Cogilith
Myron	Divape
Cyrus	DabZ
Dayton	Ntag
Ulises	Wikido
Rex	Quimba
Hakeem	Zooxo
Rocky	Eabox
River	Avaveo
Kadeem	Jamia
Jayden	Zoomdog
Erich	Riffwire
Bradly	Twitterworks
Jackie	Devcast
Ryne	Flipstorm
Brandyn	Tavu
Aldo	Yadel
Camron	Riffpath
Jamarcus	Dabvine
Alton	Chatterpoint
Keon	Jazzy
Clyde	Twimm
Rico	Rhynyx
Nick	Quimba
Kane	Ozu
Estevan	Skidoo
Devonta	Topiczoom
Brandan	Twitterwire
Dylon	Divape
Dangelo	Oyondu
Talon	Rooxo
Cecil	Voolia
Sonny	Dabfeed
Demarco	Aivee
Dillion	Skipfire
Herman	Linkbuzz
Brennen	Quamba
Donnell	Vinder
Eliezer	Shufflester
Randolph	Edgeify
Benito	Meedoo
Vance	Photolist
August	Divape
Royce	Zoomdog
Kellen	Dabfeed
Coby	Linkbridge
Cordell	Agivu
Quinten	Leexo
Floyd	Jabbertype
Javonte	Youtags
Aric	Lazzy
Silas	Yoveo
Ibrahim	Zoozzy
Bryon	Geba
Kieran	Divavu
Remingto	Mymm
Tariq	Livefish
Devyn	Centimia
Jaylon	Edgeblab
Anderson	Gigazoom
Gunner	Quamba
Octavio	Vimbo
Tory	Latz
Shea	Mycat
Darwin	Bubbletube
Jacoby	Kwinu
Codey	Skidoo
Marquez	Minyx
Layne	Tagpad
Hernan	Brightbean
Bronson	Wikizz
Caden	Feedfish
Keanu	Meevee
Junior	Yombu
Lionel	Myworks
Demario	Feedspan
Raymundo	Einti
Eliseo	Yakijo
Grady	Pixonyx
Kenton	Shuffledrive
Otis	Trupe
Shay	Realblab
Austyn	Plambee
Jabari	Oyoba
Ari	Izio
Garett	Youspan
Rusty	Skidoo
Muhammad	Devify
Chester	Skiba
Tayler	Photofeed
Niko	Tagopia
Fidel	Devify
Dominque	Brainsphere
Bo	Zazio
Adrien	JumpXS
Jerrell	Digitube
Elvin	Bluezoom
Codie	Thoughtworks
Tyron	Talane
Isai	Omba
Emmett	Pixoboo
Montana	Quinu
Lincoln	Feedfire
Kelsey	Brainverse
Amos	Oyoyo
Keven	Minyx
Dario	Gabvine
Khalid	Gevee
Dakotah	Oyoloo
Dallin	Eamia
Darrian	Chatterbridge
Mateo	Feedspan
Garrison	Rhynyx
Jamaal	Plajo
Justus	Fadeo
Elisha	Fivechat
Deondre	Jabberbean
Dontae	Agimba
Kobe	Realbuzz
Lyle	Ainyx
Forest	Yoveo
Justyn	Vitz
Edmond	Blogtags
Ervin	Feedspan
Chadwick	Eayo
Aiden	Dabfeed
Schuyler	Kayveo
Jerald	Skibox
Derik	Edgepulse
Destin	Omba
Broderic	Realbuzz
Dusty	Geba
Isidro	Voomm
Adonis	Npath
Mikel	Photobean
Spenser	Skiba
Vaughn	Jabberbean
Davin	Edgewire
Daron	Gigabox
Orion	Plambee
Tavon	Skynoodle
Darrion	Devcast
Stone	Photolist
Antwon	Twitterwire
Raekwon	Buzzbean
Dejuan	Rhycero
Maximill	LiveZ
Deshaun	Feedbug
Jude	Edgeblab
Tyshawn	Fanoodle
Ron	Fivebridge
Kelby	Divanoodle
Domenic	Realbridge
Ulysses	Fivespan
Jerod	Dynazzy
Kelton	Aimbo
Morris	Kamba
Rey	Dynabox
Abdiel	Tekfly
Efren	Oozz
Kevon	Kwilith
Hudson	Twimm
Kendal	Realcube
Mickey	Wikido
Najee	Zoomcast
Ryder	Youspan
Brandt	Jazzy
Kirby	Cogilith
Armani	Riffwire
Kalvin	Dabtype
Syed	Demivee
Tyquan	Linklinks
Jedidiah	Babbleopia
Brant	Riffwire
Reggie	Fadeo
Valentin	Jaloo
Jomar	Devbug
Marques	Thoughtstorm
Armand	Jabbercube
Ellis	Rhycero
Kegan	Izio
Carlo	Livefish
Diamond	Zoozzy
Justen	Fivespan
Jovanny	Brainlounge
Kwame	Livepath
Romeo	Dabfeed
Dionte	Yabox
Nicklaus	Photolist
Darrien	Voomm
Trae	Buzzbean
Galen	Talane
Devontae	Zoombox
Denver	Vinte
Kole	Reallinks
