Jaxbean	Malta
Npath	Yemen
Photolist	Malaysia
Edgewire	Palestinian Territory
Gabvine	Ecuador
Blogpad	Lebanon
Devcast	Australia
Fivebridge	Thailand
Geba	Gambia
Thoughtstorm	Australia
Voonix	Portugal
Wordware	Venezuela
Topiclounge	Greece
Vidoo	Hungary
Meevee	Bosnia and Herzegovina
Skyba	Sudan
Avaveo	Barbados
Twiyo	Ethiopia
Flipopia	United States
Kazio	Tunisia
Shuffledrive	Vietnam
Yadel	Mauritius
Rhynyx	Brazil
Youspan	Ireland
Oyoyo	Colombia
Vinte	Lebanon
Agimba	Malawi
Topicstorm	Indonesia
Divavu	Lebanon
Browsecat	Pakistan
Edgepulse	Guadeloupe
DabZ	Benin
Skidoo	Dominican Republic
Twimbo	Japan
Bluezoom	El Salvador
Tavu	Israel
Kwilith	Guatemala
Buzzdog	Barbados
Minyx	Jordan
Skiba	Barbados
Digitube	Bolivia
Izio	Albania
Camido	Togo
Photospace	Luxembourg
Topicshots	Peru
Pixoboo	Malaysia
Abatz	Netherlands
Jamia	Vietnam
Roomm	Yemen
Twitterlist	Gambia
Quinu	Chile
Wikibox	Peru
Mydo	Thailand
BlogXS	Egypt
Skinder	Hungary
Jabberbean	Tanzania
Tagpad	Malaysia
Vinder	Venezuela
Gigabox	Norway
Eayo	Jamaica
Skalith	Bosnia and Herzegovina
Skimia	Croatia
Quaxo	Ethiopia
Skiptube	Kazakhstan
Yacero	Afghanistan
Fivespan	Pakistan
Trudoo	Japan
Podcat	Malawi
Fliptune	Guadeloupe
Quimba	Kenya
Janyx	Norway
Plambee	Kenya
Yakitri	Canada
Quatz	Comoros
Quimm	Serbia
Dabshots	Armenia
Snaptags	Japan
Blognation	Tunisia
Quamba	Iran
Feedfish	France
Meemm	Poland
Eidel	Lesotho
Aimbu	Nicaragua
Rhybox	Thailand
Voolia	Kenya
Feedfire	Pakistan
Mita	China
Yombu	Zimbabwe
Pixope	Bolivia
Realbridge	Benin
Jetpulse	Ireland
Ozu	Libya
Wikizz	Lebanon
Dynabox	Guadeloupe
Shuffletag	Bosnia and Herzegovina
Tagchat	Greece
Jaxnation	Venezuela
Jabberstorm	Togo
Tagtune	Togo
Aimbo	Norway
Oba	Palestinian Territory
Feedbug	El Salvador
JumpXS	Kenya
Voomm	Nepal
Zoomdog	Bulgaria
Fadeo	Tajikistan
Aivee	Tunisia
Chatterbridge	Australia
Nlounge	Colombia
Oyonder	Zambia
Katz	Kenya
Riffpedia	Ivory Coast
Twitterworks	Tanzania
Zoomcast	Pakistan
Dabfeed	Belarus
Kayveo	Kazakhstan
Oozz	Armenia
Jabbersphere	Russia
Einti	Netherlands
Trupe	Netherlands
Photobug	France
Zoozzy	Armenia
Eabox	Ivory Coast
Brainlounge	Russia
Gabtype	Egypt
Kwinu	Central African Republic
Livefish	Malta
Tanoodle	Hungary
Yakijo	Germany
Skipstorm	Iceland
Myworks	Barbados
Brightdog	Japan
Leexo	Jamaica
Dabjam	Bolivia
Yoveo	Poland
Dynazzy	Vietnam
Gevee	Japan
Vitz	Finland
Demimbu	Barbados
Tagcat	Tunisia
Mudo	Uzbekistan
Wordtune	Bolivia
Thoughtbeat	Spain
Miboo	Bolivia
Muxo	Slovenia
Midel	Bosnia and Herzegovina
Meembee	Australia
Zooxo	Portugal
Bubblemix	Nepal
Tambee	Jamaica
Thoughtblab	Lesotho
Centimia	Mexico
Riffwire	Cayman Islands
Ailane	Moldova
Teklist	Panama
Flashdog	Mongolia
Kaymbo	Nepal
Avamm	Australia
Devshare	Netherlands
Skilith	Mongolia
Agivu	Gambia
Jetwire	Greece
Thoughtsphere	Sweden
Skipfire	Norway
Mybuzz	Ireland
Innotype	Ecuador
Realcube	Palestinian Territory
Flashpoint	Tunisia
Linklinks	Czech Republic
Jabbertype	Japan
Lazzy	Malta
Jaloo	Kenya
Rooxo	Finland
Flipstorm	Philippines
Twimm	Tanzania
Linktype	Iran
Rhyzio	Serbia
Photobean	Malawi
Divape	Mongolia
Youfeed	Dominican Republic
Tazzy	Zimbabwe
Ntag	United Kingdom
Youtags	Vietnam
Quire	Nigeria
Jabbercube	Palestinian Territory
Browsetype	Peru
Fatz	Cayman Islands
Plajo	Ethiopia
Roodel	Netherlands
Tekfly	Uzbekistan
Buzzster	Australia
Oyoloo	Ivory Coast
Realbuzz	East Timor
Reallinks	Nepal
Roombo	Peru
Livepath	Hungary
Devbug	Jamaica
Eire	Macedonia
Mycat	Estonia
Mynte	Argentina
Voonte	Philippines
Yabox	Malta
Centidel	Macedonia
Twinte	Central African Republic
Cogidoo	France
Livetube	South Korea
Brainsphere	Afghanistan
Zoombox	Albania
Skynoodle	Zambia
Mymm	Netherlands
Meedoo	Guatemala
InnoZ	Japan
Fanoodle	Indonesia
Eamia	Tanzania
Brainverse	Nigeria
Rhyloo	Afghanistan
Shufflester	Estonia
Tagopia	Croatia
Oyondu	Ecuador
Zava	Syria
Jayo	Gambia
Oyoba	Tajikistan
Gigashots	China
Buzzbean	Brazil
Linkbridge	Tanzania
Yodo	Yemen
Rhycero	Japan
Kamba	Malta
Cogibox	Ireland
Topiczoom	Ethiopia
Omba	Belarus
Ainyx	Cuba
Babbleopia	South Korea
Linkbuzz	Vietnam
Cogilith	Nepal
Gabspot	Zambia
Kwideo	Vietnam
Bubbletube	Cuba
Innojam	Cayman Islands
Twitterwire	Luxembourg
Ooba	Colombia
Gabcube	Netherlands
Zazio	Syria
Talane	Indonesia
Brightbean	Bosnia and Herzegovina
Dabvine	Malta
Trudeo	Philippines
Dablist	Greece
Yodoo	Malta
Jaxworks	Peru
Thoughtworks	Malta
Brainbox	Ukraine
Skivee	Malawi
Wikido	Australia
Skyndu	Canada
Zoonder	Netherlands
Edgeify	Ireland
Fivechat	Comoros
Riffpath	Luxembourg
Devify	Poland
Flipbug	Philippines
LiveZ	Bulgaria
Divanoodle	Czech Republic
Gigazoom	Guadeloupe
Photofeed	Peru
Avamba	Japan
Pixonyx	Australia
Oodoo	Panama
Youbridge	Malta
Eimbee	Myanmar
Latz	Jamaica
Bluejam	Peru
Dabtype	Albania
Gabtune	Lebanon
Realblab	Thailand
Yodel	Zimbabwe
Twitterbridge	Serbia
Browsebug	United Kingdom
Tazz	Malaysia
Feedspan	Nigeria
Trilith	Nigeria
Skyble	Azerbaijan
Gigaclub	Mauritius
Skyvu	Nepal
Skibox	Vietnam
Meejo	Moldova
Blogtags	Malaysia
Jazzy	Nigeria
Demivee	Belarus
Vimbo	El Salvador
Yamia	Gambia
Leenti	Finland
Meezzy	Jamaica
Skippad	Benin
Edgetag	Honduras
Chatterpoint	Nepal
Zoomlounge	Japan
Edgeblab	Canada
Jaxspan	Brazil
Layo	Chile
